"a" = (/turf,/area)
"b" = (/turf/grounds/desert,/area)
"c" = (/turf/grounds/cavefloor,/area)
"d" = (/turf/grounds/lavas/lava,/area)
"e" = (/obj/Items/gems/Diamond,/turf/grounds/cavefloor2,/area)
"f" = (/turf/grounds/cavefloor2,/area)
"g" = (/obj/Items/gems/Ruby,/obj/PermPortal1,/turf/grounds/cavefloor2,/area)
"h" = (/mob/Monsters/DemonNPC,/turf/grounds/cavefloor2,/area)
"i" = (/obj/Items/gems/Emerald,/turf/grounds/cavefloor2,/area)

(1,1,1) = {"
aaaaaaaaaaaaaaaaaaaaaaaaaaaaaaaaaaaaaaaaaaaaaaaaaaaaaaaaaaaaaaaaaaaaaaaaaaa
aaaaaaaaaaaaaaaaaaaaaaaaaaaaaaaaaaaaaaaaaaaaaaaaaaaaaaaaaaaaaaaaaaaaaaaaaaa
aaaaaaaaaaaaaaaaaaaaaaaaaaaaaaaaaaaaaaaaaaaaaaaaaaaaaaaaaaaaaaaaaaaaaaaaaaa
aaaaaaaaaaaaaaaaaaaaaaaaaaaaaaaaaaaaaaaaaaaaaaaaaaaaaaaaaaaaaaaaaaaaaaaaaaa
aaaaaaaaaaaaaaaaaaaaaaaaaaaaaaaaaaaaaaaaaaaaaaaaaaaaaaaaaaaaaaaaaaaaaaaaaaa
aaaaaaaaaaaaaaaaaaaaaaaaaaaaaaaaaaaaaaaaaaaaaaaaaaaaaaaaaaaaaaaaaaaaaaaaaaa
bbbbbbbbbbbbbbbbbbbbbbbbbbbbbbbbbbbbbbbbbbbbbbbbbbbbbbbbbbbaaaaaaaaaaaaaaaa
bbbbbbbbbbbbbbbbbbbbbbbbbbbbbbbbbbbbbbbbbbbbbbbbbbbbbbbbbbbaaaaaaaaaaaaaaaa
bbbbbbbbbbbbbbbbbbbbbbbbbbbbbbbbbbbbbbbbbbbbbbbbbbbbbbbbbbbaaaaaaaaaaaaaaaa
bbbbbbbbbbbbbbbbbbbbbbbbbbbbbbbbbbbbbbbbbbbbbbbbbbbbbbbbbbbaaaaaaaaaaaaaaaa
bbbbbbbbbbbbbbbbbbbbbbbbbbbbbbbbccccccbbbbbbbbbbbbbbbbbbbbbaaaaaaaaaaaaaaaa
bbbbbbbbbbbbbbbbbbbbbbbbbbbbbbbccccccccbbbccccccbbbbbbbbbbbaaaaaaaaaaaaaaaa
bbbbbbbbbbbbbbbbbbbbbbbbbbbbbbccccccccccccccccccccbbbbbbbbbaaaaaaaaaaaaaaaa
bbbbbbbbbbbbbbbbbbbbbbccbbbbbbcccccccccccccccccccccbbbbbbbbaaaaaaaaaaaaaaaa
bbbbbbbbbbbbbbbbbbbcccccccccccccccccccccccccccccccccbbbbbbbaaaaaaaaaaaaaaaa
bbbbbbbbbbbbbbbbcccccccccccccccccccccccccccccccccccccbbbbbbaaaaaaaaaaaaaaaa
bbbbbbbbbbbbbbcccccccccccccccccccccccccccccccccccccccbbbbbbaaaaaaaaaaaaaaaa
bbbbbbbbbbbbccccccccccccccccccccccccccccccccccccccccccbbbbbaaaaaaaaaaaaaaaa
bbbbbbbbbbccccccccccccccccccccccccccccccccccccccccccccbbbbbaaaaaaaaaaaaaaaa
bbbbbbbbbccccccccccccccccccccccccccccccccccccccccccccccbbbbaaaaaaaaaaaaaaaa
bbbbbbbbbcccccccccccccccccccccccccccccccccccccccccccccccbbbaaaaaaaaaaaaaaaa
bbbbbbbbbccccccccccccccccccccccccccccccccccccccccccccccccbbaaaaaaaaaaaaaaaa
bbbbbbbbbcccccccccccccccccccccccccccccccccccccccccccccccccbaaaaaaaaaaaaaaaa
bbbbbbbbbccccccccccccccccccccccccccccccccccccccccccccccccccaaaaaaaaaaaaaaaa
bbbbbbcccccccccccccccccccccccccccccccccccccccccccccccccccccaaaaaaaaaaaaaaaa
bbbbbbcccccccccccccccccccccccccccccccccccccccccccccccccccccaaaaaaaaaaaaaaaa
bbbbbcccccccccccccccccccccccdddddddddcccccccccccccccccccccbaaaaaaaaaaaaaaaa
bbbbcccccccccccccccccccccccdddddddddddccccccccccccccccccccbaaaaaaaaaaaaaaaa
bbbcccccccccccccccccccccccdddefdddfedddcccccccccccccccccccbaaaaaaaaaaaaaaaa
bbbcccccccccccccccccccccccdddffdddffdddccccccccccccccccccccaaaaaaaaaaaaaaaa
bbbcccccccccccccccccccccccdddddfgfdddddccccccccccccccccccccaaaaaaaaaaaaaaaa
bbbcccccccccccccccccccccccddddddhddddddcccccccccccccccccccbaaaaaaaaaaaaaaaa
bbbccccccccccccccccccccccccdddidddidddccccccccccccccccccccbaaaaaaaaaaaaaaaa
bbbccccccccccccccccccccccccddfffffffddccccccccccccccccccccbaaaaaaaaaaaaaaaa
bbbcccccccccccccccccccccccccdididididccccccccccccccccccccbbaaaaaaaaaaaaaaaa
bbcccccccccccccccccccccccccccdddddddcccccccccccccccccccccbbaaaaaaaaaaaaaaaa
bbccccccccccccccccccccccccccccdddddcccccccccccccccccccccbbbaaaaaaaaaaaaaaaa
bcccccccccccccccccccccccccccccccccccccccccccccccccccccccbbbaaaaaaaaaaaaaaaa
ccccccccccccccccccccccccccccccccccccccccccccccccccccccccbbbaaaaaaaaaaaaaaaa
cccccccccccccccccccccccccccccccccccccccccccccccccccccccccbbaaaaaaaaaaaaaaaa
cccccccccccccccccccccccccccccccccccccccccccccccccccccccccbbaaaaaaaaaaaaaaaa
ccccccccccccccccccccccccccccccccccccccccccccccccccccccccccbaaaaaaaaaaaaaaaa
ccccccccccccccccccccccccccccccccccccccccccccccccccccccccccbaaaaaaaaaaaaaaaa
ccccccccccccccccccccccccccccccccccccccccccccccccccccccccccbaaaaaaaaaaaaaaaa
bccccccccccccccccccccccccccccccccccccccccccccccccccccccccbbaaaaaaaaaaaaaaaa
bcccccccccccccccccccccccccccccccccccccccccccccccccccccccbbbaaaaaaaaaaaaaaaa
bccccccccccccccccccccccccccccccccccccccccccccccccccccccbbbbaaaaaaaaaaaaaaaa
bcccccccccccccccccccccccccccccccccccccccccccccccccccccbbbbbaaaaaaaaaaaaaaaa
bcccccccccccccccccccccccccccccccccccccccccccccccccccbbbbbbbaaaaaaaaaaaaaaaa
bccccccccccccccccccccccccccccccccccccccccccccccccccbbbbbbbbaaaaaaaaaaaaaaaa
bcccccccccccccccccccccccccccccccccccccccccccccccccbbbbbbbbbaaaaaaaaaaaaaaaa
bcccccccccccccccccccccccccccccccccccccccccccccccccbbbbbbbbbaaaaaaaaaaaaaaaa
bcccccccccccccccccccccccccccccccccccccccccccccccccbbbbbbbbbaaaaaaaaaaaaaaaa
bcccccccccccccccccccccccccccccccccccccccccccccccccbbbbbbbbbaaaaaaaaaaaaaaaa
bcccccccccccccccccccccccccccccccccccccccccccccccccbbbbbbbbbaaaaaaaaaaaaaaaa
bcccccccccccccccccccccccccccccccccccccccccccccccccbbbbbbbbbaaaaaaaaaaaaaaaa
bbcccccccccccccccccccccccccccccccccccccccccccccccbbbbbbbbbbaaaaaaaaaaaaaaaa
bbbbcccccccccccccccccccccccccccccccccccccccccccccbbbbbbbbbbaaaaaaaaaaaaaaaa
bbbbbccccccccccccccccccccccccccccccccccccccccccbbbbbbbbbbbbaaaaaaaaaaaaaaaa
bbbbbbcccccccccccccccccccccccccccccccccccccccccbbbbbbbbbbbbaaaaaaaaaaaaaaaa
bbbbbbccccccccccccccccccccccccccccccccccccccccbbbbbbbbbbbbbaaaaaaaaaaaaaaaa
bbbbbbccccccccccccccccccccccccccccccccccccccccbbbbbbbbbbbbbaaaaaaaaaaaaaaaa
bbbbbbbbbbbcccccccccccccccccccccccccccccccccccbbbbbbbbbbbbbaaaaaaaaaaaaaaaa
bbbbbbbbbbbbcccccccccccccccccccccccccccccccccbbbbbbbbbbbbbbaaaaaaaaaaaaaaaa
bbbbbbbbbbbbbcccccccccccccccccccccccccccccccbbbbbbbbbbbbbbbaaaaaaaaaaaaaaaa
bbbbbbbbbbbbbbbccccccccccccccccccccccccccccbbbbbbbbbbbbbbbbaaaaaaaaaaaaaaaa
bbbbbbbbbbbbbbbccccccccccccccccccccccccccccbbbbbbbbbbbbbbbbaaaaaaaaaaaaaaaa
bbbbbbbbbbbbbbbbbbbbcccccccccccccccccccccccbbbbbbbbbbbbbbbbaaaaaaaaaaaaaaaa
bbbbbbbbbbbbbbbbbbbbbccccccccccccccccccccccbbbbbbbbbbbbbbbbaaaaaaaaaaaaaaaa
bbbbbbbbbbbbbbbbbbbbbbcccccccccccccccccccccbbbbbbbbbbbbbbbbaaaaaaaaaaaaaaaa
bbbbbbbbbbbbbbbbbbbbbbcccccccccccccccccccbbbbbbbbbbbbbbbbbbaaaaaaaaaaaaaaaa
bbbbbbbbbbbbbbbbbbbbbbbcccccccccccccccccbbbbbbbbbbbbbbbbbbbaaaaaaaaaaaaaaaa
bbbbbbbbbbbbbbbbbbbbbbbbccccccccccccccccbbbbbbbbbbbbbbbbbbbaaaaaaaaaaaaaaaa
bbbbbbbbbbbbbbbbbbbbbbbbbccccbbbbbbbbbbbbbbbbbbbbbbbbbbbbbbaaaaaaaaaaaaaaaa
bbbbbbbbbbbbbbbbbbbbbbbbbbbcbbbbbbbbbbbbbbbbbbbbbbbbbbbbbbbaaaaaaaaaaaaaaaa
"}
